Alabama : Ala.
Alberta : Alta.
Arizona : Ariz.
Arkansas: Ark.
Australian Capital Territory : A.C.T.
British Columbia : B.C.
California: Calif.
Colorado : Colo.
Connecticut : Conn.
Delaware : Del.
District of Columbia : D.C.
Distrito Federal : D.F.
Florida : Fla.
Georgia : Ga.
Illinois: Ill.
Indiana : Ind.
Kansas: Kan.
Kentucky : Ky.
Louisiana: La.
Maine: Me.
Manitoba : Man.
Maryland : Md.
Massachusetts : Mass.
Michigan : Mich.
Minnesota : Minn.
Mississippi : Miss.
Missouri : Mo.
Montana : Mont.
Nebraska : Neb.
Nevada : Nev.
New Brunswick : N.B.
New Hampshire : N.H.
New Jersey : N.J.
New Mexico : N.M.
New South Wales : N.S.W.
New York : N.Y.
New Zealand : N.Z.
Newfoundland : Nfld.
North Carolina : N.C.
North Dakota : N.D.
Northern Territory : N.T.
Northwest Territories : N.W.T.
Nova Scotia : N.S.
Oklahoma : Okla.
Ontario : Ont.
Oregon : Or.
Pennsylvania : Pa.
Prince Edward Island : P.E.I.
Puerto Rico : P.R.
Quebec : Que.
Queensland : Qld.
Rhode Island : R.I.
Russian Soviet Federated Socialist Republic : R.S.F.S.R.
Saskatchewan : Sask.
South Australia : S. Aust.
South Carolina : S.C.
South Dakota : S.D.
Tasmania : Tas.
Tennessee : Tenn.
Territory of Hawaii : T.H.
Texas : Tex.
Union of Soviet Socialist Republics : U.S.S.R.
United Kingdom : U.K.
United States : U.S.
Vermont: VT.
Victoria : Vic.
Virgin Islands : V.I.
Virginia : Va.
Washington: Wash.
West Virginia : W. Va.
Western Australia : W.A.
Wisconsin : Wis.
Wyoming : Wyo.
Yukon Territory : Yukon
